4 4 4 4 4 4 4 4 4 4 4 4 4 4 4 4 4 4 4 4 4 4 4 4 4 4 4 4 4 4 4 4 4 4 4 4 
4 32 32 32 32 32 32 32 32 32 32 32 32 32 32 32 32 32 32 32 32 32 32 32 32 32 32 32 32 32 32 32 32 32 32 4 
4 32 32 4 4 4 4 4 4 4 4 4 4 4 4 4 4 4 4 4 4 4 4 4 4 4 4 4 4 4 4 4 32 32 32 4 
4 32 32 4 32 32 32 32 32 32 32 32 32 32 32 32 32 32 32 32 32 32 32 32 32 32 32 32 32 32 32 4 32 32 32 4 
4 32 32 4 32 32 4 4 4 4 4 4 4 32 32 32 32 4 32 32 32 32 4 4 4 4 4 4 4 32 32 4 32 32 32 4 
4 32 32 4 32 32 4 4 4 4 4 4 32 32 32 32 4 32 4 32 32 32 32 4 4 4 4 4 4 32 32 4 32 32 32 4 
4 32 32 4 32 32 4 4 4 4 4 32 32 32 32 4 32 32 32 4 32 32 32 32 4 4 4 4 4 32 32 4 32 32 32 4 
4 32 32 4 32 32 4 4 4 4 32 32 32 32 4 32 32 32 32 32 4 32 32 32 32 4 4 4 4 32 32 4 32 32 32 4 
4 32 32 4 32 32 4 4 4 32 32 32 32 4 32 32 32 32 32 32 32 4 32 32 32 32 4 4 4 32 32 4 32 32 32 4 
4 32 32 4 32 32 4 4 32 32 32 32 4 32 32 32 32 4 4 32 32 32 4 32 32 32 32 4 4 32 32 4 32 32 32 4 
4 32 32 4 32 32 32 32 32 32 32 4 32 32 32 32 4 32 32 4 32 32 32 4 32 32 32 32 32 32 32 4 32 32 32 4 
4 32 32 4 32 32 32 32 32 32 4 32 32 32 32 4 32 32 32 32 4 32 32 32 4 32 32 32 32 32 32 4 32 32 32 4 
4 32 32 4 32 32 32 32 32 4 32 32 32 32 4 32 32 32 32 32 32 4 32 32 32 4 4 4 4 4 4 4 32 32 32 4 
4 32 32 4 4 4 4 4 4 32 32 32 32 4 32 32 32 32 32 32 32 32 4 32 32 32 32 32 32 32 32 32 32 32 32 4 
4 32 32 32 32 32 32 32 32 32 32 32 4 32 32 32 32 32 32 32 32 32 32 4 32 32 32 32 32 32 32 32 32 32 32 4 
4 4 4 4 4 4 4 4 4 4 4 4 32 32 32 32 32 6 32 32 32 32 32 32 4 4 4 4 4 4 4 4 4 4 4 4 
